#################
#          RRRRO#
# XRXXXSRRRR OR #
#ORR X  O   RRR #
#RR  X    RRR X #
#RO RRRRRRR     #
#R RR     X     #
#R R   RRRR     #
#RRBRRRRO       #
#################
