#################
#SRRRRRRRRR     #
#        OR     #
#     RRRRR     #
#     R         #
# O   R         #
# RRRRR         #
# RT     T      #
# R             #
#################