#################
#     RRRRRRRRRR#
# X   R  O  X   #
#     R         #
#     R    X    #
# O   R      O  #
#     R  T      #
#  T  R       X #
#     RRRRRR    #
#################